---------------------------------------------------------------------------------------------------------------------------------------------------------------------------------------------------------------------
-wwwwwwwwwwwwwwwwwwwwwwwwwwwwwwwwwwwwwwwwwwwwwwwwwwwwwwwwwwwwwwwwwwwwwwwwwwwwwwwwwwwwwwwwwwwwwwwwwwwwwwwwwwwwwwwwwwwwwwwwwwwwwwwwwwwwwwwwwwwwwwwwwwwwwwwwwwwwwwwwwwwwwwwwwwwwwwwwwwwwwwwwwwwwwwwwwwwwwwwwwwwwwwwwwww-
-w                                                                                                                                                                                                                 w-
-w                                                                                                                                                                                                                 w-
-w                              l                                                                                                                                                                                  w-
-w                                                                                                                                                                                                                 w-
-w                                                                                                                                                                                                                 w-
-w                                                                        w                                                                                                                                        w-
-w                                                                      wwwwwww                                                                                                                                    w-
-w                                       A    wwww                         w                                                                                                                                       w-
-w                        c    @l                                                                                                                                                                                  w-
-w                                                       ww                                                                                                                                                        w-
-w                             .                                                                                                                                                                                   w-
-w                                                                                                                                                                                                                 w-
-w                                                                                                                                                                                                                 w-
-w                                                                                                                                                                                                                 w-
-w                                                                                                                                                                                                                 w-
-w                                                                                                                                                                                                                 w-
-w                                                                                                                                                                                                                 w-
-w                                                                                                                                                                                                                 w-
-w                                                                                                                                                                                                                 w-
-w                                                                                                                                                                                                                 w-
-w                                                                                                                                                                                                                 w-
-w                                                                                                                                                                                                                 w-
-w                                                                                                                                                                                                                 w-
-w                                                                                                                                                                                                                 w-
-w                                                                                                                                                                                                                 w-
-w                                                                                                                                                                                                                 w-
-w                                                                                                                                                                                                                 w-
-w                                                                                                                                                                                                                 w-
-w                                                                                                                                                                                                                 w-
-w                                                                                                                                                                                                                 w-
-w                                                                                                                                                                                                                 w-
-w                                                                                                                                                                                                                 w-
-w                                                                                                                                                                                                                 w-
-w                                                                                                                                                                                                                 w-
-w                                                                                                                                                                                                                 w-
-w                                                                                                                                                                                                                 w-
-w                                                                                                                                                                                                                 w-
-wwwwwwwwwwwwwwwwwwwwwwwwwwwwwwwwwwwwwwwwwwwwwwwwwwwwwwwwwwwwwwwwwwwwwwwwwwwwwwwwwwwwwwwwwwwwwwwwwwwwwwwwwwwwwwwwwwwwwwwwwwwwwwwwwwwwwwwwwwwwwwwwwwwwwwwwwwwwwwwwwwwwwwwwwwwwwwwwwwwwwwwwwwwwwwwwwwwwwwwwwwwwwwwwwww-
---------------------------------------------------------------------------------------------------------------------------------------------------------------------------------------------------------------------
