
  wwwwwwwwwwwwwwwwwwwwwwwwwwwwwwwwwwwwwwwwwwwwwwwwwwwwwwwwwwwwwwwwwww                                               ,--,  ,.-.           wwwwwwwwwwwwwwwwwwwwwwwwwwwwwwwwwwwwwwwwwwwwwwwwwwwwwwwwwwwwwwwwwww
  w-----------------------------------------------------------------w                  ,                   \,       '-,-`,'-.' | ._      w-----------------------------------------------------------------w
  w-----------------------------------------------------------------w                 /|           \    ,   |\         }  )/  / `-,',    w-----------------------------------------------------------------w
  w-----------------------------------------------------------------w                 [ '          |\  /|   | |        /  \|  |/`  ,`    w-----------------------------------------------------------------w
  w-----------------------------------------------------------------w                 | |       ,.`  `,` `, | |  _,...(   (      _',     w-----------------------------------------------------------------w
  w-----------------------------------------------------------------w                 \  \  __ ,-` `  ,  , `/ |,'      Y     (   \_L\    w-----------------------------------------------------------------w
  w-----------------------------------------------------------------w                  \  \_\,``,   ` , ,  /  |         )         _,/    w-----------------------------------------------------------------w
  w------------------------------------------------@----------------w                   \  '  `  ,_ _`_,-,<._.<        /         /       w-----------------------------------------------------------------w
  w-----------------------------------------------------------------w                    ', `>.,`  `  `   ,., |_      |         /        w-----------------------------------------------------------------w
  w-----------------------------------------------------------------w                      \/`  `,   `   ,`  | /__,.-`    _,   `\        w-----------------------------------------------------------------w
  w-----------------------------------------------------------------w                  -,-..\  _  \  `  /  ,  / `._) _,-\`       \       w-----------------------------------------------------------------w
  w-----------------------------------------------------------------w                   \_,,.) /\    ` /  / ) (-,, ``    ,        |      w-----------------------------------------------------------------w
  w-----------------------------------------------------------------w                  ,` )  | \_\       '-`  |  `(               \      w-----------------------------------------------------------------w
  w-----------------------------------------------------------------w                 /  /```(   , --, ,' \   |`<`    ,            |     w-----------------------------------------------------------------w
  w-----------------------------------------------------------------w                /  /_,--`\   <\  V /> ,` )<_/)  | \      _____)     w-----------------------------------------------------------------w
  w-----------------------------------------------------------------w          ,-, ,`   `   (_,\ \    |   /) / __/  /   `----`           w-----------------------------------------------------------------w
  w-----------------------------------------------------------------w         (-, \           ) \ ('_.-._)/ /,`    /                     w-----------------------------------------------------------------w
  w-----------------------------------------------------------------w         | /  `          `/ \\ V   V, /`     /                      w-----------------------------------------------------------------w
  w-----------------------------------------------------------------w      ,--\(        ,     <_/`\\     ||      /                       w-----------------------------------------------------------------w
  w-----------------------------------------------------------------w     (   ,``-     \/|         \-A.A-`|     /                        w-----------------------------------------------------------------w
  w-----------------------------------------------------------------w    ,>,_ )_,..(    )\          -,,_-`  _--`                         w-----------------------------------------------------------------w
  w-----------------------------------------------------------------w   (_ \|`   _,/_  /  \_            ,--`                             w-----------------------------------------------------------------w
  w-----------------------------------------------------------------w    \( `   <.,../`     `-.._   _,-`                                 w-----------------------------------------------------------------w
  wwwwwwwwwwwwwwwwwwwwwwwwwwwwwwwwwwwwwwwwwwwwwwwwwwwwwwwwwwwwwwwwwww     `                      ```                                     wwwwwwwwwwwwwwwwwwwwwwwwwwwwwwwwwwwwwwwwwwwwwwwwwwwwwwwwwwwwwwwwwww
